11 11 11 11 11 11 11 11 11 11 11 11 11 11 11 11 11 11 11 11 11 11 11 11 11 11 11 11 11 11 11 11 
11 18 18 18 18 18 18 18 18 18 18 18 18 18 18 18 18 18 18 18 18 18 18 18 18 18 18 18 18 18 18 11 
11 18 18 18 18 18 18 18 18 18 18 18 18 18 18 18 18 18 18 18 18 18 18 18 18 18 18 18 18 18 18 11 
11 18 18 24 18 18 18 18 18 18 18 18 18 18 18 18 18 18 18 18 18 18 18 18 18 18 18 18 24 18 18 11 
11 18 18 18 18 18 18 18 18 18 18 18 18 18 18 18 18 18 18 18 18 18 18 18 18 19 18 18 18 18 18 11 
11 18 18 18 19 19 19 19 19 19 18 18 18 18 18 18 18 18 18 18 18 18 19 18 18 18 18 18 19 18 18 11 
11 18 18 18 18 18 18 18 18 19 18 18 18 18 18 18 18 18 18 18 18 19 18 18 18 18 18 18 18 18 18 11 
11 18 18 18 18 18 18 18 18 19 18 18 18 18 18 18 18 18 20 20 20 20 18 18 18 18 18 18 18 18 18 11 
11 18 18 18 18 18 18 18 18 19 18 18 18 18 18 18 18 18 20 20 20 20 18 18 18 18 18 18 18 18 18 11 
11 18 18 18 18 18 18 18 18 19 18 18 18 18 18 18 18 18 20 20 20 20 18 18 18 18 19 18 18 18 18 11 
11 18 18 18 18 18 19 19 19 19 18 18 18 18 18 18 18 18 19 18 18 18 18 18 18 18 18 18 18 18 18 11 
11 18 18 18 18 18 18 18 18 18 18 18 18 18 18 18 18 18 18 18 18 18 18 19 18 18 18 18 18 18 18 11 
11 18 18 18 18 18 18 18 18 18 18 18 18 18 18 18 18 18 18 18 18 18 18 18 18 18 18 18 18 18 18 11 
11 18 18 18 18 18 18 18 18 18 18 18 18 18 18 18 19 18 18 18 18 18 18 18 18 18 18 18 18 18 18 11 
11 18 18 18 20 18 18 18 20 18 18 18 18 18 18 18 18 18 18 18 18 18 18 18 18 18 18 18 18 18 18 11 
11 18 18 18 20 18 18 20 20 18 18 18 18 18 18 18 18 18 18 18 18 18 19 18 18 18 18 18 18 18 18 11 
11 18 18 18 20 20 18 20 18 18 18 18 18 18 18 18 18 18 18 18 18 18 18 18 18 18 18 18 18 18 18 11 
11 18 18 18 18 20 18 20 18 18 18 18 19 18 18 18 18 18 18 19 18 18 18 18 18 18 18 18 18 18 18 11 
11 18 18 18 18 18 20 18 18 18 18 18 18 18 18 18 18 18 18 18 18 18 18 18 18 18 18 18 18 18 18 11 
11 18 18 18 18 18 18 18 18 18 18 18 18 18 18 18 18 18 18 18 18 18 18 18 18 18 18 18 18 18 18 11 
11 18 18 18 18 18 18 18 18 18 18 18 18 18 18 18 18 19 18 18 18 18 18 18 18 18 18 18 18 18 18 11 
11 18 18 18 18 18 18 18 18 18 18 18 18 18 18 18 18 18 18 18 18 18 18 19 18 18 18 18 18 18 18 11 
11 18 18 18 18 18 18 18 18 18 18 18 18 18 18 18 18 18 18 18 18 18 18 19 18 18 18 18 18 18 18 11 
11 18 18 18 18 18 18 18 18 18 18 18 18 18 18 18 18 18 18 18 18 18 18 19 18 18 18 18 18 18 18 11 
11 18 18 18 18 18 18 18 18 20 18 18 18 18 18 18 18 18 18 18 18 20 18 18 18 18 18 18 18 18 18 11 
11 18 18 18 18 18 18 18 18 20 18 18 18 18 18 18 18 18 18 18 18 20 18 18 18 18 18 18 18 18 18 11 
11 18 18 18 18 18 18 18 18 20 18 19 18 18 18 18 18 18 18 18 18 20 18 18 18 18 19 18 18 18 18 11 
11 18 18 18 18 18 18 18 18 20 18 18 18 18 18 18 18 18 18 18 18 20 18 18 18 18 18 18 18 18 18 11 
11 18 18 24 18 18 18 18 18 20 18 18 18 18 18 18 18 18 19 18 18 20 18 18 18 18 18 18 24 18 18 11 
11 18 18 18 18 18 18 18 18 20 20 20 20 20 20 20 20 20 20 20 20 20 18 18 18 18 18 18 18 18 18 11 
11 18 18 18 18 18 18 18 18 18 18 18 18 18 18 18 18 19 19 18 18 18 18 18 18 18 18 18 18 18 18 11 
11 11 11 11 11 11 11 11 11 11 11 11 11 11 11 11 11 11 11 11 11 11 11 11 11 11 11 11 11 11 11 11 
